###########
#oo@   @oo#
#oo     oo#
#  #@@@#@ #
#  @   @  #
#  @ A @  #
# @#@@@#  #
#oo     oo#
#oo@   @oo#
###########