########  
# oo#  #  
# oo# @###
#  ##    #
## @   @ #
 # ##  ###
 #   @##  
 ###  #
   #A #   
   ####   